DENV1_1_LEFT	AGTACAAGAGTCTACGTGGACCGACAAGAA
DENV1_1_RIGHT	AAACATCGGGCATCAGCATAAGGAGCATGG
DENV1_2_LEFT	AGTACAAGTGGCTAGATGGGGCTCATTCAA
DENV1_2_RIGHT	AAACATCGTCGCCAGTTTGGGAACATGTTC
DENV1_3_LEFT	AGTACAAGGGATTTGGGAGAGTTATGTGAGGAC
DENV1_3_RIGHT	AAACATCGTCCTGACAGTCCTTCCACGAAG
DENV1_4_LEFT	AGTACAAGGCACATGCCATAGGAACATCCA
DENV1_4_RIGHT	AAACATCGACGTTCGTCGACACACAAAGTT
DENV1_5_LEFT	AGTACAAGTGGACATTGAACTCTTGAAGACGG
DENV1_5_RIGHT	AAACATCGTGCAGTTGTCCCATGTTCTGTG
DENV1_6_LEFT	AGTACAAGAGTGTGTGACAAAACTGGAAGGAA
DENV1_6_RIGHT	AAACATCGTCCTGCTTCTTTGCATGAGCTG
DENV1_7_LEFT	AGTACAAGTGGCTAGTCCACAAACAATGGTTT
DENV1_7_RIGHT	AAACATCGCATGGTGCATCTGTTCCTTCGT
DENV1_8_LEFT	AGTACAAGAGATGGACAAACTGACTCTAAAAGGG
DENV1_8_RIGHT	AAACATCGTCCAACAGACGTGAACACTCCT
DENV1_9_LEFT	AGTACAAGAGCTGGTTCAAGAAAGGAAGCA
DENV1_9_RIGHT	AAACATCGTGCTCTGTCCAAGTGTGAACTT
DENV1_10_LEFT	AGTACAAGTGCAGTTGGCCTAGTAACGCTA
DENV1_10_RIGHT	AAACATCGGTTCCATGGGTTGTGGCCTAAT
DENV1_11_LEFT	AGTACAAGACATCATGTGGAAGCAAATATCAAATGAA
DENV1_11_RIGHT	AAACATCGTATCCAGTACCCCATGTCAGCG
DENV1_12_LEFT	AGTACAAGTGGATTTGGAATTTTCACGACAAACA
DENV1_12_RIGHT	AAACATCGCCGTGGTACCCTCACACAAATC
DENV1_13_LEFT	AGTACAAGTGATAATTCCAAAGATCTATGGAGGACC
DENV1_13_RIGHT	AAACATCGGCAGTCCTAGTGAAAAGCTGTCC
DENV1_14_LEFT	AGTACAAGAGGAGAAGATGGGTGCTGGTAC
DENV1_14_RIGHT	AAACATCGTCTCTGGATGTTAGTCTGCGGA
DENV1_15_LEFT	AGTACAAGTATGCATCATGGTTGGAGCCAA
DENV1_15_RIGHT	AAACATCGTGGACAGGCATAAGGGGAAGAG
DENV1_16_LEFT	AGTACAAGTGACTGACTTTCAATCACATCAGCT
DENV1_16_RIGHT	AAACATCGGCTTCTTCTTCCCAGGAGACCT
DENV1_17_LEFT	AGTACAAGAAAATGATGTGCCGCTAGCTGG
DENV1_17_RIGHT	AAACATCGACTTCTGGAGGGCTAGGTGTGT
DENV1_18_LEFT	AGTACAAGCTCTGCTAGCAGTTTCAGGGGT
DENV1_18_RIGHT	AAACATCGTCTTCTCCCGTGTTCCAGGATC
DENV1_19_LEFT	AGTACAAGATGTCACCAGGGGAGCTGTACT
DENV1_19_RIGHT	AAACATCGGCCCTTCTTGTGATGCTTTAGCT
DENV1_20_LEFT	AGTACAAGTAAACCCGGCACATCTGGATCT
DENV1_20_RIGHT	AAACATCGTGAAAGTGGCGTGACACATGAG